21 21 21 21 21 21 21 21 21 21 21 21 21 21 21 21 21 21 21 21 21 21 21 21 21 21 21 21 21 21 21 21 21 21 21 21 21 21 21 21 21 21 21 21 21 21 21 21 21 21 
21 21 21 21 21 21 21 21 21 21 21 21 21 21 21 21 21 21 21 21 21 21 21 21 21 21 21 21 21 21 21 21 21 21 21 21 21 21 21 21 21 21 21 21 21 21 21 21 21 21 
21 21 21 21 21 21 21 21 21 21 21 21 21 21 21 21 21 21 21 21 21 21 21 21 21 21 21 21 21 21 21 21 21 21 21 21 21 21 21 21 21 21 21 21 21 21 21 21 21 21 
21 21 21 22 22 22 21 21 21 21 21 21 21 22 22 22 22 22 22 21 21 21 21 21 21 21 21 21 21 21 21 21 21 21 21 22 22 31 29 29 29 29 32 21 21 21 21 21 21 21 
22 22 22 22 22 22 22 22 22 22 22 22 22 21 22 22 22 22 21 22 22 22 22 22 22 22 21 21 21 22 22 22 22 22 22 22 22 27 2 3 3 2 26 22 22 21 21 21 21 21 
22 22 22 22 22 21 21 21 21 21 21 22 22 22 22 22 22 22 22 22 21 21 22 22 22 22 21 21 21 21 22 22 22 22 22 22 22 27 3 2 2 3 26 21 21 21 22 21 21 21 
21 21 21 22 21 21 21 21 21 21 21 22 22 22 21 21 21 21 21 21 21 21 22 21 21 21 21 21 21 21 21 21 21 22 22 22 22 27 3 3 2 3 26 22 22 22 22 21 21 21 
21 21 22 22 22 21 20 20 20 20 20 20 20 20 20 20 20 20 20 20 20 20 20 20 20 20 20 20 21 21 21 21 22 22 21 22 22 33 24 24 24 24 34 22 22 21 21 21 21 21 
21 21 22 22 22 21 20 1 1 1 1 1 1 1 1 1 1 1 1 1 1 1 1 1 1 1 1 20 21 21 21 22 22 21 22 22 21 21 21 21 21 21 21 22 21 22 22 21 21 21 
21 21 22 22 22 21 20 20 20 20 20 20 20 20 20 20 20 20 20 20 20 20 20 20 20 20 1 20 21 21 22 22 21 22 22 21 21 22 22 22 22 22 21 21 21 21 21 21 21 21 
21 22 22 22 22 21 21 21 21 21 21 21 21 21 21 21 21 21 21 21 21 21 21 21 21 20 1 20 21 22 22 21 22 22 22 22 22 22 22 22 22 21 21 21 21 21 21 21 21 21 
22 22 22 22 21 21 21 21 21 21 21 21 21 21 21 21 21 21 22 22 21 21 21 22 22 20 1 20 21 22 21 22 22 21 21 21 21 22 22 21 21 21 21 21 21 21 21 21 21 21 
21 21 22 22 22 21 22 22 22 22 22 22 22 22 21 21 22 22 22 21 21 21 22 22 21 20 1 20 21 22 22 22 22 22 22 31 32 22 22 22 22 22 22 22 22 22 21 22 22 21 
22 22 22 22 22 22 22 22 22 22 22 21 21 21 21 22 22 21 22 22 22 22 22 22 21 20 1 20 21 21 21 21 21 21 21 33 34 21 22 22 22 22 22 22 22 22 22 22 21 21 
21 21 21 21 21 21 21 21 21 21 21 21 21 21 22 22 22 22 22 21 21 21 21 21 21 20 1 20 21 21 21 21 21 21 21 21 21 22 22 22 22 21 21 21 21 21 21 21 21 21 
21 21 21 21 21 21 21 21 21 21 21 21 21 21 22 22 22 21 21 21 21 21 21 21 21 20 1 20 21 21 21 21 21 21 21 21 21 21 21 21 21 21 21 21 21 21 21 21 21 21 
2 2 2 2 2 19 19 19 19 19 19 19 19 19 19 19 19 19 19 19 19 19 2 2 10 5 5 5 9 2 19 19 2 2 2 2 2 2 19 19 19 19 19 19 19 19 19 19 19 19 
19 19 19 2 19 19 19 19 19 19 19 19 19 19 19 19 19 19 19 19 19 19 19 19 10 5 5 5 9 2 19 19 19 19 19 19 19 19 19 19 19 19 19 19 19 19 2 2 2 2 
19 2 19 19 19 19 19 19 19 2 2 2 19 19 19 2 2 2 2 19 19 2 2 19 10 5 5 5 9 2 19 19 2 2 19 19 2 2 2 19 19 19 19 19 19 2 2 2 2 2 
2 2 19 19 19 2 2 19 19 2 2 2 19 19 19 19 19 19 19 19 19 19 19 19 10 5 5 5 9 2 2 19 19 19 19 19 19 19 19 19 19 19 19 19 19 19 19 19 19 19 
19 19 19 19 19 19 19 19 19 19 19 19 19 19 19 19 19 19 19 19 19 19 2 2 10 5 5 5 9 2 2 19 19 19 19 19 19 19 19 19 2 19 19 19 19 19 19 19 19 2 
12 12 12 12 12 12 12 12 12 12 12 12 12 12 12 12 12 12 12 12 12 12 12 12 13 5 5 5 11 12 12 12 12 12 12 12 12 12 12 12 12 12 12 12 12 12 12 12 12 12 
5 5 5 5 5 5 5 5 5 5 5 5 5 5 5 5 5 5 5 5 5 5 5 5 5 5 5 5 5 5 5 5 5 5 5 5 5 5 5 5 5 5 5 5 5 5 5 5 5 5 
5 5 5 5 5 5 5 5 5 5 5 5 5 5 5 5 5 5 5 5 5 5 5 5 5 5 5 5 5 5 5 5 5 5 5 5 5 5 5 5 5 5 5 5 5 5 5 5 5 5 
7 7 7 7 19 19 7 19 19 7 7 19 7 19 7 7 19 7 7 7 7 19 7 19 8 5 5 5 6 7 7 7 7 7 7 7 7 7 7 19 19 19 19 19 19 19 19 19 19 2 
3 19 19 19 19 19 19 19 19 19 19 19 19 19 19 19 19 19 19 19 19 19 19 19 19 5 5 5 9 2 19 19 19 19 19 19 19 19 19 19 19 19 19 19 19 19 19 19 19 2 
3 19 19 19 19 19 19 19 19 19 19 19 19 19 19 19 19 19 19 19 19 19 19 19 10 5 5 5 9 19 19 19 19 19 19 19 19 19 19 19 19 19 19 19 19 19 19 19 19 19 
19 19 19 19 19 19 19 19 2 3 3 3 3 2 19 19 19 19 19 19 19 19 19 19 19 5 5 5 9 19 19 2 19 19 19 19 19 19 19 19 19 19 19 19 2 2 19 19 19 19 
19 19 19 19 3 3 2 3 20 20 20 20 3 3 19 3 3 19 19 19 19 19 19 19 10 5 5 5 9 19 19 19 19 19 19 19 19 19 2 19 19 19 19 19 19 19 19 19 19 19 
19 19 19 19 20 20 20 20 20 1 1 20 3 19 19 19 19 19 19 19 19 3 19 19 10 5 5 5 9 2 19 19 19 19 19 19 19 19 19 19 19 19 19 19 19 19 19 19 19 19 
19 19 19 19 20 18 1 1 1 1 1 20 12 12 19 12 19 19 19 19 19 19 19 19 10 5 5 5 9 2 19 19 19 19 19 19 19 19 19 19 19 19 19 19 19 19 19 19 19 19 
19 19 19 19 20 1 1 1 20 1 1 5 5 5 5 5 19 19 19 19 19 19 19 19 10 5 5 5 9 19 19 19 19 19 19 19 19 19 19 19 19 19 19 19 19 19 19 19 19 19 
19 19 19 2 20 1 1 1 20 20 20 20 7 7 8 5 19 19 2 19 19 19 19 19 10 5 5 5 9 19 19 19 2 19 19 19 19 19 19 19 19 19 19 19 19 19 19 19 19 2 
2 19 2 2 20 20 20 20 20 19 19 19 19 19 19 5 9 19 19 19 19 19 19 19 10 5 5 5 9 19 19 19 19 19 19 19 19 19 19 19 19 2 2 2 2 2 2 2 2 2 
24 24 24 24 24 24 24 24 24 25 19 19 2 19 19 5 9 2 19 19 2 19 19 2 10 5 5 5 9 19 19 19 2 19 19 19 19 19 19 19 2 2 23 24 24 24 24 24 24 24 
21 21 21 21 21 21 21 21 21 27 19 19 19 19 10 5 11 12 19 19 12 12 12 19 13 5 5 5 9 19 19 19 19 19 19 2 19 19 19 19 19 2 26 21 21 21 21 21 21 21 
21 22 22 22 22 22 22 21 21 27 19 19 19 19 10 5 5 5 5 5 5 5 5 5 5 5 5 5 9 19 19 19 19 19 19 19 19 19 19 19 19 2 26 22 22 21 21 21 21 21 
21 21 21 22 22 21 22 22 21 27 19 19 19 19 16 7 7 7 7 19 19 7 7 19 8 5 5 5 9 19 19 19 19 19 19 19 19 19 19 19 19 2 26 21 22 22 22 21 22 21 
21 21 22 22 22 22 21 21 21 27 19 19 19 19 2 19 19 19 19 19 19 2 2 2 10 5 5 5 9 19 19 19 19 19 19 19 2 19 19 19 19 2 26 21 21 21 22 22 22 21 
21 22 22 22 22 22 22 22 21 27 2 19 19 19 19 19 19 19 19 2 2 2 2 19 19 5 5 5 9 19 19 19 19 2 2 2 2 2 2 2 2 2 26 21 21 21 22 21 22 22 
21 22 22 22 21 21 21 22 21 33 24 24 24 24 24 24 24 25 2 2 2 19 2 19 10 5 5 5 9 19 19 19 19 2 23 24 24 24 24 24 24 24 34 21 21 22 22 22 22 22 
21 22 22 21 21 21 22 22 21 21 21 21 21 21 21 21 21 27 19 2 19 19 19 19 19 5 5 5 9 19 19 19 2 2 26 21 21 21 21 21 21 21 21 21 21 22 21 22 21 22 
21 22 22 22 22 21 22 21 21 21 22 21 21 21 21 21 21 27 2 19 19 19 19 19 19 5 5 5 11 12 12 12 12 4 26 21 22 22 21 21 21 21 21 21 21 22 22 22 21 22 
21 21 22 22 21 21 22 22 22 22 22 22 22 22 21 21 21 27 4 5 5 5 5 5 5 5 5 5 5 5 5 5 5 9 26 22 22 22 22 22 22 22 22 22 22 22 22 22 22 22 
21 22 22 21 21 21 21 21 21 21 21 21 21 22 22 21 21 27 10 5 5 5 5 5 5 5 5 5 5 5 5 5 5 9 26 22 21 21 21 31 29 29 32 21 21 21 22 22 22 22 
21 22 22 22 22 22 22 22 21 21 21 21 21 21 22 21 21 27 4 5 5 5 5 5 5 5 5 5 5 5 5 5 5 4 26 22 22 21 21 27 3 2 26 21 21 21 22 22 22 22 
21 21 21 21 22 22 22 21 21 21 21 21 21 21 22 21 21 27 4 7 4 7 7 7 4 7 7 4 7 7 4 7 7 17 26 22 22 21 21 27 3 2 26 21 21 21 21 22 22 21 
21 21 21 22 22 22 22 22 22 22 22 22 21 21 22 21 21 33 24 24 24 24 24 24 24 24 24 24 24 24 24 24 24 24 34 21 22 21 21 33 24 24 34 21 21 21 21 22 22 21 
21 21 21 21 21 21 21 21 21 21 22 22 22 22 22 22 21 21 21 21 21 21 21 21 22 22 22 22 22 22 22 22 22 22 21 22 22 22 22 21 21 22 22 22 22 22 22 22 21 21 
21 21 21 21 21 21 21 21 22 22 22 21 21 21 21 21 21 21 21 21 22 22 22 22 22 21 21 21 21 21 21 21 21 21 21 21 22 21 22 22 22 22 21 21 21 21 21 21 21 21 
